GEOID,PLACE,total_population,white,black,native_american,asian,aapi,other_race,multi_race,hispanic,total_homes,total_occupied_homes,vacant_homes,renter_occupied_homes,owner_occupied_homes,civilian_employed,civilian_unemployed,civilian_labor_force,gini_index,median_home_value,median_income
1600000US3651000,New York city,8804190,3000945,1943645,86218,1385144,6874,1494267,887097,2490350,3618635,3370448,248187,2365346,1005102,3800934,506815,4307749,0.5472,685700,67997
1600000US0644000,Los Angeles city,3898747,1359068,336096,66491,462643,5960,1150176,518313,1829991,1496453,1410260,86193,904306,505954,1871710,223430,2095140,0.5264,812800,70372
1600000US1714000,Chicago city,2746388,986280,801195,34543,192586,1087,434452,296245,819518,1262612,1142725,119887,670526,472199,1336812,150246,1487058,0.532,297300,66576
1600000US4835000,Houston city,2304580,739873,520389,27428,167189,1366,476667,371668,1013423,998195,896482,101713,528720,367762,1119499,102161,1221660,0.5364,236700,55499
1600000US0455000,Phoenix city,1608139,799174,125260,41053,66169,3699,323859,248925,661574,630752,583009,47743,261683,321326,806532,50861,857393,0.468,352600,68435
1600000US4260000,Philadelphia city,1603797,582636,630462,6212,133553,932,139102,110900,238277,726797,658075,68722,340647,317428,714754,83786,798540,0.5142,220700,52899
1600000US4865000,San Antonio city,1434625,636003,102816,17543,47784,2142,240088,388249,916010,592430,538253,54177,255137,283116,679129,52568,731697,0.4603,197600,54923
1600000US0666000,San Diego city,1386932,643304,82265,12722,247860,5683,195734,199364,411286,548934,515676,33258,276714,238962,687670,61106,748776,0.4654,768800,93042
1600000US4819000,Dallas city,1304379,470819,303577,15376,48588,687,253858,211474,551174,572194,523520,48674,313903,209617,648744,41625,690369,0.5286,267600,57995
1600000US0668000,San Jose city,1013240,276523,29308,14665,390532,4082,184363,113767,316266,342037,328622,13415,151152,177470,503384,35616,539000,0.4634,1119500,126377
1600000US4805000,Austin city,961855,526024,69757,9277,86876,708,114145,155068,312448,444426,410868,33558,241389,169479,570435,31868,602303,0.4939,482900,79542
1600000US1235000,Jacksonville city,949611,475813,290279,3578,48617,1054,44052,86218,110081,411541,378587,32954,166711,211876,454451,22362,476813,0.4652,239400,58621
1600000US4827000,Fort Worth city,918915,412158,180439,7881,47716,1175,130594,138952,319836,346699,323092,23607,142438,180654,459562,24585,484147,0.4594,249000,68235
1600000US3918000,Columbus city,905748,482058,259483,3556,56218,395,38912,65126,70179,415456,382038,33418,220165,161873,478018,31757,509775,0.4362,219200,58202
1600000US1836003,Indianapolis city (balance),887642,461795,248067,4627,37785,407,68073,66888,116221,398007,361641,36366,173181,188460,437469,28128,465597,0.4618,188700,58479
1600000US3712000,Charlotte city,874579,365111,289062,5674,61789,526,83682,68735,142704,379904,355413,24491,175434,179979,481242,25495,506737,0.4911,321400,70869
1600000US0667000,San Francisco city,873965,361382,46725,6475,296505,3476,73169,86233,136761,406628,371851,34777,244927,126924,448416,40991,489407,0.5322,1306400,121826
1600000US5363000,Seattle city,737015,451623,51419,5197,125668,2109,23539,77460,60563,368308,345627,22681,200543,145084,445494,25045,470539,0.4953,848100,110781
1600000US0820000,Denver city,715522,433946,64038,10601,27875,1531,80773,96758,199460,344980,317326,27654,169252,148074,410721,27378,438099,0.4864,541500,81630
1600000US1150000,Washington city,689545,273194,285810,3193,33545,432,37294,56077,77652,350364,312448,37916,192703,119745,355398,31749,387147,0.5305,669900,90088
1600000US4752006,Nashville-Davidson metropolitan government (balance),689447,380838,169349,3839,27375,318,55554,52174,96349,316363,290106,26257,142564,147542,370353,16455,386808,0.4932,346700,64857
1600000US4055000,Oklahoma City city,681054,364706,95634,23476,31510,1089,75426,89213,144761,297627,268035,29592,114454,153581,331578,20764,352342,0.4528,190900,59214
1600000US4824000,El Paso city,678815,250001,25077,7581,10347,1514,139967,244328,551513,261229,243598,17631,100178,143420,291020,24959,315979,0.4744,152800,51241
1600000US2507000,Boston city,675647,318101,138870,2824,76021,356,68274,71201,126113,301702,279495,22207,190050,89445,358975,31312,390287,0.5348,659700,79283
1600000US4159000,Portland city,652503,449025,38217,7335,52854,3919,31255,69898,72336,302034,282110,19924,141520,140590,358649,27495,386144,0.4773,520200,79057
1600000US3240000,Las Vegas city,641903,295594,82485,7318,46398,4662,109045,96401,213828,256713,240787,15926,112489,128298,285402,35078,320480,0.4935,362400,59746
1600000US2622000,Detroit city,639111,68407,496534,2931,10193,160,29681,31205,51269,309913,254275,55638,137893,116382,222936,46865,269801,0.5089,69300,36140
1600000US4748000,Memphis city,633104,158380,389779,2501,11624,198,41075,29547,62167,286713,255642,31071,141368,114274,279303,30507,309810,0.5221,142800,44317
1600000US2404000,Baltimore city,585708,163026,338478,2312,21210,186,28046,32450,45927,293249,251479,41770,142477,109002,270242,23252,293494,0.5129,193100,54652
1600000US5553000,Milwaukee city,577222,208169,222746,5303,30264,243,52181,58316,116306,257723,235410,22313,142501,92909,260052,19443,279495,0.4801,160100,46637
1600000US3502000,Albuquerque city,564559,294953,19833,31707,18938,671,80062,118395,269238,254635,237826,16809,97939,139887,275304,17902,293206,0.4708,251500,58512
1600000US0477000,Tucson city,542629,295986,30342,15842,17236,1522,82249,99452,228878,242798,223270,19528,110941,112329,254885,18825,273710,0.4545,224800,50306
1600000US0627000,Fresno city,542107,179727,40972,13015,79670,994,145287,82442,273771,184226,175944,8282,90970,84974,230540,23708,254248,0.482,321300,61250
1600000US0664000,Sacramento city,524943,182637,69167,7215,104358,8637,80516,72413,151253,202231,192560,9671,97767,94793,252089,20521,272610,0.4603,449600,75311
1600000US2938000,Kansas City city,508090,280985,132617,3221,15966,1501,28063,45737,60969,241949,216452,25497,105378,111074,265554,17607,283161,0.4617,213400,63396
1600000US0446000,Mesa city,504258,331118,21249,13718,13306,2068,60717,62082,137490,220082,191469,28613,72031,119438,248420,10939,259359,0.4384,350100,69266
1600000US1304000,Atlanta city,498715,198240,235513,1406,22367,218,11921,29050,29988,258245,228070,30175,134744,93326,263095,14434,277529,0.5536,375500,74107
1600000US3137000,Omaha city,486051,318218,60280,5426,22377,461,35233,44056,75563,207148,193609,13539,84897,108712,251918,10850,262768,0.496,211900,62948
1600000US0816000,Colorado Springs city,478961,336546,28351,5061,16215,1590,29795,61403,87897,200855,190219,10636,75529,114690,237254,15925,253179,0.4282,390500,74579
1600000US3755000,Raleigh city,467665,249126,122766,2581,23611,235,34957,34389,60514,208114,195659,12455,101357,94302,249549,14644,264193,0.4906,340200,74612
1600000US0643000,Long Beach city,466742,149347,58334,7002,60874,4330,119618,67237,201997,179530,170711,8819,101899,68812,231137,19313,250450,0.4617,693600,73905
1600000US5182000,Virginia Beach city,459470,278956,85478,1894,34305,756,13959,44122,40404,190059,178353,11706,66872,111481,221892,9573,231465,0.4373,328500,81634
1600000US1245000,Miami city,442241,133690,57254,1890,6145,90,63383,179789,310472,212146,187379,24767,134272,53107,230791,14452,245243,0.5667,411300,48789
1600000US0653000,Oakland city,440646,132297,93820,8530,70806,2884,80504,51805,126843,178469,167909,10560,101902,66007,222304,18493,240797,0.5022,848600,82236
1600000US2743000,Minneapolis city,429954,255704,82038,7433,24929,201,25186,34463,44513,199143,187670,11473,105377,82293,239940,22138,262078,0.4966,319100,69397
1600000US4075000,Tulsa city,413066,214012,61526,21471,14352,905,40513,60287,79057,191364,171638,19726,85950,85688,189482,14381,203863,0.5169,172000,51008
1600000US0603526,Bakersfield city,403455,157062,28305,7433,31599,688,111412,66956,212822,132697,127864,4833,52211,75653,173796,15819,189615,0.4569,318600,66666
1600000US2079000,Wichita city,397532,251997,43537,5296,20225,482,29444,46551,72786,174295,158851,15444,67458,91393,187955,14590,202545,0.4673,165700,56293
1600000US4804000,Arlington city,394266,159599,90140,4260,30423,496,53713,55635,120944,151697,142650,9047,65574,77076,199363,13594,212957,0.4499,254700,59889
1600000US2148006,Louisville/Jefferson County metro government (balance),629176,411703,150640,540,16842,340,10579,38532,43002,286976,261105,25871,103370,157735,306622,17273,323895,0.4784,203900,57182
1600000US0804000,Aurora city,386261,181903,61526,5476,24873,1660,52310,58513,116902,147745,140590,7155,56285,84305,203635,12559,216194,0.4291,411400,71647
1600000US1271000,Tampa city,384959,191309,84340,1563,20895,308,29385,57159,98621,170964,157193,13771,81670,75523,194119,10878,204997,0.54,336200,63404
1600000US2255000,New Orleans city,383997,126462,208273,1337,10703,147,12409,24666,31017,193840,165125,28715,90067,75058,166526,17283,183809,0.5664,279100,46942
1600000US3916000,Cleveland city,372624,128443,180224,1598,10517,162,23380,28300,48699,198871,167681,31190,101266,66415,157055,21965,179020,0.4916,83400,35562
1600000US0602000,Anaheim city,346824,107740,9253,6207,61539,1533,101765,58787,186651,110388,105740,4648,58021,47719,167074,14015,181089,0.443,688400,81747
1600000US2146027,Lexington-Fayette urban county,322570,220236,48076,1105,13427,144,16732,22850,29750,146142,134535,11607,63795,70740,167953,9524,177477,0.4906,242400,60942
1600000US0675000,Stockton city,320804,75439,40487,5563,70548,2678,81948,44141,141601,101913,97736,4177,47981,49755,132826,15506,148332,0.4351,382900,69844
1600000US4817000,Corpus Christi city,317863,170219,13996,2706,7905,357,40390,82290,192990,134397,118823,15574,49728,69095,143124,8027,151151,0.4676,171500,59812
1600000US3231900,Henderson city,317610,200585,21355,2366,29684,2430,19276,41914,56964,136325,126963,9362,46608,80355,146123,13506,159629,0.4596,421300,77924
1600000US0662000,Riverside city,314998,114991,20100,6164,23159,1121,95332,54131,172386,100255,96270,3985,44113,52157,154975,15029,170004,0.4099,483300,76558
1600000US3451000,Newark city,311549,37777,154048,2256,5047,190,74525,37706,113374,118163,108789,9374,89211,19578,121179,21849,143028,0.5109,323200,43242
1600000US2758000,St. Paul city,311527,157458,52256,3235,59955,141,14944,23538,30084,127392,120572,6820,62389,58183,158728,10690,169418,0.4629,267700,66098
1600000US0669000,Santa Ana city,310227,57376,3343,11403,38004,828,139920,59353,238022,79181,76622,2559,41680,34942,150621,11399,162020,0.4231,623000,80265
1600000US3915000,Cincinnati city,309317,147532,125443,903,7861,157,9393,18028,15836,158773,139567,19206,88294,51273,148106,12112,160218,0.5574,190300,42733
1600000US0636770,Irvine city,307670,115957,6972,829,140443,397,13310,29762,35855,119215,110007,9208,60807,49200,151550,11107,162657,0.4784,970500,105774
1600000US1253000,Orlando city,307573,122998,73320,1246,13359,219,37906,58525,101061,140895,128181,12714,82283,45898,164921,13884,178805,0.5021,319800,54167
1600000US4261000,Pittsburgh city,302971,189948,69050,729,19836,116,5313,17979,11620,157695,139726,17969,79151,60575,153587,11891,165478,0.5282,181100,57821
1600000US2965000,St. Louis city,301578,132292,129814,948,12289,102,7760,18373,15405,173479,144870,28609,86005,58865,147952,10026,157978,0.4968,170800,49965
1600000US3728000,Greensboro city,299035,119709,125574,1744,15168,146,16874,19820,30419,131976,122250,9726,62791,59459,146933,10022,156955,0.4867,186200,51825
1600000US3436000,Jersey City city,292449,79905,58103,1916,81903,178,41970,28474,72777,130992,119517,11475,90326,29191,142742,13415,156157,0.5197,487400,81958
1600000US0203000,Anchorage municipality,291247,164446,14576,23661,27646,10001,10115,40802,26438,118640,109343,9297,43713,65630,137213,9767,146980,0.4336,346200,86654
1600000US3128000,Lincoln city,291082,228956,13605,2589,13871,196,10175,21690,24934,123819,116701,7118,50904,65797,162717,4635,167352,0.4409,228000,62294
1600000US4858016,Plano city,285494,141385,25523,2011,68960,158,17172,30285,45799,115234,109436,5798,47460,61976,150943,8106,159049,0.4592,387200,95002
1600000US3719000,Durham city,283506,113925,102742,1999,16017,107,27768,20948,43470,128005,119052,8953,61328,57724,148622,8207,156829,0.4737,325000,71343
1600000US3611000,Buffalo city,278349,116767,102636,1885,21288,149,14763,20861,35643,136350,119119,17231,74265,44854,118681,13469,132150,0.5087,155200,40669
1600000US0412000,Chandler city,275987,161121,16514,5327,33152,660,22547,36666,62257,108388,102543,5845,38296,64247,153265,5243,158508,0.4255,435100,94613
1600000US0613392,Chula Vista city,275487,72083,13991,3608,42683,1458,69760,71904,164698,87284,84579,2705,35656,48923,128931,13865,142796,0.4474,655100,91949
1600000US3977000,Toledo city,270871,157947,77897,1114,3209,97,8098,22509,24136,132054,117483,14571,57588,59895,122382,12497,134879,0.4555,100100,44150
1600000US5548000,Madison city,269840,191627,20019,1318,25658,157,10148,20913,23408,126070,120737,5333,66787,53950,153175,5076,158251,0.4746,321800,67270
1600000US0427400,Gilbert town,267918,191689,10198,2808,18043,649,12095,32436,45132,93230,88896,4334,23772,65124,139837,6117,145954,0.3887,484600,104802
1600000US3260600,Reno city,264165,165657,8072,3586,18816,2028,31652,34354,66980,116568,108597,7971,56899,51698,136703,6773,143476,0.4717,469100,67478
1600000US1825000,Fort Wayne city,263886,171433,40311,1300,15312,121,14721,20688,27896,115860,107308,8552,42375,64933,125773,7966,133739,0.4366,155600,54737
1600000US3251800,North Las Vegas city,262527,81366,57941,3100,17496,2739,57500,42385,106940,86353,82620,3733,33630,48990,119757,15174,134931,0.4097,335200,67035
1600000US1263000,St. Petersburg city,258308,165822,54348,766,9095,135,6479,21663,23289,134731,120089,14642,52027,68062,132526,7344,139870,0.4936,315200,64141
1600000US4845000,Lubbock city,257141,152995,26083,2779,9423,217,29984,35660,91545,111247,100563,10684,49621,50942,130562,7532,138094,0.4923,171400,54747
1600000US4837000,Irving city,256684,71138,32484,3551,57504,309,49263,42435,105469,101643,95485,6158,60478,35007,132517,7176,139693,0.4477,274100,70340
1600000US4841464,Laredo city,255205,97301,1118,1603,1389,51,50126,103617,242818,80734,75037,5697,28625,46412,103965,7239,111204,0.4767,157400,52438
1600000US3775000,Winston-Salem city,249545,114386,81148,1833,6339,233,26592,19014,42841,112140,102171,9969,48146,54025,115183,7699,122882,0.5155,197300,54228
1600000US5116000,Chesapeake city,249422,139573,72268,1174,9057,377,6807,20166,17824,94829,91162,3667,27148,64014,120362,5790,126152,0.4127,320600,88815
1600000US0427820,Glendale city,248325,126983,19027,5003,11639,574,46153,38946,97617,91912,86483,5429,38368,48115,118055,8688,126743,0.4362,325400,62910
1600000US4829000,Garland city,246018,86453,37094,3250,29487,148,47279,42307,104945,86182,82069,4113,32525,49544,112761,6217,118978,0.4109,232300,61607
1600000US0465000,Scottsdale city,241361,195573,4854,1886,12084,257,7852,18855,23533,136490,114950,21540,40730,74220,128657,5724,134381,0.5149,674900,99097
1600000US5157000,Norfolk city,238005,102841,95594,1328,9025,521,9445,19251,23130,101386,93447,7939,53488,39959,101338,4867,106205,0.4435,250300,58591
1600000US1608830,Boise City city,235684,191462,5345,1639,8429,693,8133,19983,21276,102295,97456,4839,38198,59258,125575,3572,129147,0.48,460200,70217
1600000US0626000,Fremont city,230504,42480,5362,1353,147465,1045,15230,17569,29016,77430,74450,2980,29715,44735,114961,5291,120252,0.4163,1175600,155968
1600000US5367000,Spokane city,228989,181516,6196,4344,6519,2712,5445,22257,16058,99938,94494,5444,41616,52878,105141,7994,113135,0.4522,318200,58714
1600000US0669088,Santa Clarita city,228673,116239,9677,2509,27431,339,36843,35635,78735,78586,76692,1894,23186,53506,109404,8899,118303,0.4262,656000,109336
1600000US2205000,Baton Rouge city,227470,79991,122461,647,7358,79,6913,10021,13518,105272,91028,14244,48563,42465,95204,11597,106801,0.5515,199600,41257
1600000US5167000,Richmond city,226610,98140,91653,898,6259,115,15441,14104,23747,111963,102359,9604,64113,38246,116583,9267,125850,0.5294,311700,51770
1600000US1230000,Hialeah city,223109,61023,2695,355,1000,23,27925,130088,209784,77475,75319,2156,40923,34396,108068,5526,113594,0.451,324000,46674
1600000US0665000,San Bernardino city,222101,53786,27875,5029,9279,920,87961,37251,151125,66147,63545,2602,32730,30815,93513,7053,100566,0.4224,350000,65311
1600000US5370000,Tacoma city,219346,125980,22666,3942,20268,4301,13776,28413,29015,92309,87221,5088,41680,45541,110405,6196,116601,0.4208,435700,77141
1600000US0648354,Modesto city,218464,101805,8975,4130,17728,2481,50466,32879,93733,76476,73959,2517,32465,41494,97399,8325,105724,0.4601,389500,70469
1600000US0137000,Huntsville city,215006,121677,63085,1429,5469,292,7348,15706,16669,100391,92074,8317,40729,51345,105337,4269,109606,0.4705,250400,70757
1600000US1921000,Des Moines city,214133,138200,25011,1474,14474,135,14178,20661,33480,95082,87958,7124,36551,51407,112146,6299,118445,0.4183,165100,60693
1600000US3684000,Yonkers city,211569,78816,38107,2588,13162,93,52084,26719,89065,85528,80548,4980,45411,35137,95694,10379,106073,0.5095,424100,66395
1600000US3663000,Rochester city,211328,76907,84752,890,8520,115,20323,19821,41869,100089,91500,8589,61205,30295,94246,11644,105890,0.4982,109700,41980
1600000US0649270,Moreno Valley city,208634,46908,33158,3992,12566,1155,74657,36198,128168,57413,55872,1541,21260,34612,92346,8303,100649,0.3684,422500,79840
1600000US3722920,Fayetteville city,208501,77801,89645,2575,6652,1043,10288,20497,26269,90326,81739,8587,43638,38101,75200,7903,83103,0.4337,150200,51629
1600000US0624680,Fontana city,208393,49777,18756,4541,17631,563,79371,37754,141269,55632,54532,1100,18109,36423,100263,9943,110206,0.3566,511000,93851
1600000US1319000,Columbus city,206922,82467,96163,827,5661,555,6614,14635,16513,90348,82360,7988,42554,39806,82744,6337,89081,0.4859,170900,52734
1600000US2582000,Worcester city,206518,110158,30485,1019,14688,81,26666,23421,50736,84281,79157,5124,47328,31829,99642,11419,111061,0.495,317800,63194
1600000US1258715,Port St. Lucie city,204851,118770,37970,780,4416,126,13876,28913,44611,81975,76114,5861,15056,61058,100821,7392,108213,0.3962,284800,71381
1600000US0541000,Little Rock city,202591,88083,82340,1196,7143,78,12193,11558,20467,98993,88229,10764,41694,46535,97119,5171,102290,0.5342,191700,53565
1600000US1304204,Augusta-Richmond County consolidated government (balance),202081,68270,112773,659,3964,411,4654,11350,11271,90192,80631,9561,41228,39403,82659,8849,91508,0.4926,131900,47921
1600000US0654652,Oxnard city,202063,50086,4819,6678,15497,585,79986,44412,150984,56615,53839,2776,24985,28854,95887,7815,103702,0.3827,569700,88268
1600000US0107000,Birmingham city,200733,47209,137296,755,3275,123,5360,6715,9274,106713,89976,16737,51410,38566,88071,7010,95081,0.529,117600,36614
1600000US0151000,Montgomery city,200603,58637,120950,713,7209,129,5749,7216,9669,93920,82835,11085,39024,43811,82453,7772,90225,0.4911,136800,46957
1600000US4827684,Frisco city,200509,101167,18005,986,52833,129,7053,20336,23016,73633,69025,4608,22865,46160,110266,5808,116074,0.4137,520200,130118
1600000US4803000,Amarillo city,200393,122694,14711,2142,8453,80,20964,31349,65302,87340,78706,8634,31840,46866,96991,3492,100483,0.4866,163400,55572
1600000US4967000,Salt Lake City city,199723,136622,5766,2886,10989,4186,19440,19834,41504,92169,84349,7820,47637,36712,121032,4849,125881,0.4892,459800,66658
1600000US2634000,Grand Rapids city,198917,119881,37567,1741,4541,83,17875,17229,32797,85288,79854,5434,37735,42119,103173,7339,110512,0.4361,206200,59596
1600000US0636000,Huntington Beach city,198711,126591,2291,1293,26346,603,15689,25898,39457,82734,79101,3633,34678,44423,101409,7978,109387,0.4414,937200,107808
1600000US2053775,Overland Park city,197238,147999,9068,694,18368,101,5037,15971,15423,86539,81567,4972,32074,49493,109873,3963,113836,0.4359,352000,89280
1600000US0630000,Glendale city,196543,128248,3573,1101,29870,145,15871,17735,33575,80193,76860,3333,49847,27013,90715,8725,99440,0.5034,995700,79633
1600000US1270600,Tallahassee city,196169,99126,68691,540,8754,111,4225,14722,16663,92527,82877,9650,51042,31835,108997,7007,116004,0.4837,246100,51224
1600000US4830464,Grand Prairie city,196100,57515,47351,2339,14982,228,38114,35571,88749,68284,65008,3276,27265,37743,96158,4628,100786,0.4186,242200,68473
1600000US4845744,McKinney city,195308,109815,25355,1367,24053,170,10943,23605,33392,72876,68366,4510,25004,43362,102859,3791,106650,0.4338,391200,98317
1600000US1210275,Cape Coral city,194016,140226,8281,584,3304,113,11325,30183,46151,90465,76686,13779,19424,57262,98560,5276,103836,0.4419,291600,66425
1600000US4659020,Sioux Falls city,192517,152142,12190,5279,5318,74,5676,11838,12269,83504,78405,5099,31790,46615,110852,2004,112856,0.4722,249600,73273
1600000US0454050,Peoria city,190985,136426,7550,2136,8828,301,12930,22814,38811,76546,70111,6435,17424,52687,93888,4554,98442,0.422,407600,92566
1600000US4459000,Providence city,190934,72001,25860,2931,11559,149,51383,27051,83815,75257,69597,5660,46288,23309,92238,9596,101834,0.5165,291200,60970
1600000US5374060,Vancouver city,190915,132335,6228,2248,10364,3401,14151,22188,30541,81809,78026,3783,40270,37756,92222,7556,99778,0.4676,399100,69993
1600000US4740000,Knoxville city,190740,132786,30477,1252,4365,114,7904,13842,15160,91908,82857,9051,44426,38431,96500,5515,102015,0.5056,193600,45700
1600000US3901000,Akron city,190469,104240,59821,514,10093,80,3058,12663,6196,92517,82970,9547,41660,41310,85265,7617,92882,0.4462,106300,41628
1600000US2270000,Shreveport city,187593,67509,105088,733,3049,108,2993,8113,6658,89863,78929,10934,36366,42563,71813,9338,81151,0.5334,161500,42034
1600000US0150000,Mobile city,187041,76275,96039,616,3388,114,2542,8067,6034,89215,77772,11443,36945,40827,79846,6754,86600,0.5066,158200,43786
1600000US4810768,Brownsville city,186738,65196,648,1265,1148,47,38258,80176,175310,63191,57460,5731,22939,34521,74034,7298,81332,0.4854,104100,47435
1600000US5156000,Newport News city,186247,74676,78687,940,6356,441,8892,16255,19288,81901,75630,6271,40062,35568,83545,6402,89947,0.427,227200,58937
1600000US1224000,Fort Lauderdale city,182760,94692,50509,595,3640,88,10739,22497,35176,103140,84409,18731,41448,42961,96028,7150,103178,0.5538,395500,64912
1600000US4714000,Chattanooga city,181099,101585,52690,1280,4993,82,8033,12436,16581,85266,76816,8450,37820,38996,87223,5524,92747,0.5021,235900,55065
1600000US0473000,Tempe city,180587,107927,12132,5555,17473,750,14415,22335,39698,82626,75530,7096,46259,29271,108362,7486,115848,0.4615,414600,68662
1600000US1703012,Aurora city,180542,73354,19626,2976,19799,82,37433,27272,74981,62763,60103,2660,21526,38577,95878,6142,102020,0.4017,232400,83996
1600000US0670098,Santa Rosa city,178127,99224,4062,4039,10938,1033,34098,24733,61082,70300,66843,3457,30748,36095,86808,6906,93714,0.4451,638500,86459
1600000US4123850,Eugene city,176654,137514,3112,2038,7207,543,7261,18979,18729,77395,73534,3861,37953,35581,87615,7561,95176,0.5033,394800,59338
1600000US0622020,Elk Grove city,176124,57371,17854,1404,58982,2560,13579,24374,33392,56211,54897,1314,14581,40316,80998,7347,88345,0.3635,569900,109242
1600000US4164900,Salem city,175535,121266,3049,2924,5598,2373,19141,21184,41302,67411,64289,3122,28697,35592,79081,4687,83768,0.4385,351300,63927
1600000US0653896,Ontario city,175265,42332,11045,4184,16243,549,66663,34249,119928,53219,51312,1907,23250,28062,83012,6276,89288,0.4106,545200,73872
1600000US3710740,Cary town,174721,101743,13879,550,39089,95,6028,13337,14376,70171,66959,3212,23620,43339,92735,5235,97970,0.4417,463200,123857
1600000US0659451,Rancho Cucamonga city,174453,74323,16089,1954,25809,486,26326,29466,65261,60129,58277,1852,23121,35156,78400,5301,83701,0.4443,632700,83850
1600000US0653322,Oceanside city,174068,89605,7076,2466,13261,2110,31332,28218,63316,67371,63032,4339,26112,36920,79498,8289,87787,0.4199,631300,78125
1600000US0640130,Lancaster city,173516,56614,37032,2874,8129,326,41316,27225,78338,55137,53280,1857,21931,31349,64031,6433,70464,0.4871,377200,64242
1600000US0629000,Garden Grove city,171949,37604,1778,1993,72962,846,35984,20782,64102,48562,47362,1200,21783,25579,80126,7326,87452,0.4436,663900,74109
1600000US1255775,Pembroke Pines city,171178,54911,34725,548,9801,86,18863,52244,85133,66543,63080,3463,19981,43099,89008,4475,93483,0.4664,368400,76439
1600000US0827425,Fort Collins city,169810,137260,2503,1424,6110,180,6086,16247,21003,71625,67731,3894,32837,34894,97989,4233,102222,0.4476,485500,73945
1600000US0655156,Palmdale city,169450,45040,23080,3584,7419,361,60642,29324,104742,49686,48355,1331,16204,32151,68979,6256,75235,0.4161,399000,73417
1600000US2970000,Springfield city,169176,137235,8063,1334,3853,304,3731,14656,9926,84016,76066,7950,44252,31814,86321,4348,90669,0.4834,154600,41808
1600000US4715160,Clarksville city,166722,94978,40657,914,4143,867,6936,18227,19671,65752,61128,4624,28489,32639,68148,3030,71178,0.3788,211100,60686
1600000US0664224,Salinas city,163542,37673,2289,5469,9693,442,74616,33360,130178,44405,43163,1242,24087,19076,68629,3581,72210,0.3878,585100,80154
1600000US0633000,Hayward city,162954,27955,14693,2562,48315,5104,43338,20987,67079,52268,50215,2053,23692,26523,78612,6198,84810,0.4406,735000,96386
1600000US3457000,Paterson city,159732,22529,39838,2427,8149,80,64205,22504,98863,52885,50326,2559,38145,12181,64199,12092,76291,0.477,311700,46451
1600000US5101000,Alexandria city,159467,82185,31903,1004,11354,94,15750,17177,29372,80479,75555,4924,45312,30243,95076,4236,99312,0.4773,630500,101162
1600000US1349008,Macon-Bibb County,157346,57778,85885,373,3251,53,3735,6271,6737,71901,62762,9139,31354,31408,65335,5858,71193,0.5103,155800,48176
1600000US0616350,Corona city,157136,63071,8702,2424,18899,616,36161,27263,73102,49584,48108,1476,17804,30304,78670,5923,84593,0.4152,620600,92606
1600000US2036000,Kansas City city,156607,64177,33715,1786,7590,370,25172,23797,54144,63446,57079,6367,24886,32193,70199,5049,75248,0.4357,140200,53884
1600000US0843000,Lakewood city,155984,112493,3002,2444,5958,229,11984,19874,35423,70596,67292,3304,29027,38265,83571,5224,88795,0.455,483300,77122
1600000US2567000,Springfield city,155929,57260,32503,1411,4565,140,37540,22510,72874,62782,58794,3988,31049,27745,56353,8315,64668,0.4726,198200,42498
1600000US0677000,Sunnyvale city,155805,46551,2228,1081,77842,491,14181,13431,25372,61272,58407,2865,32584,25823,82503,5516,88019,0.4577,1575200,156059
1600000US2836000,Jackson city,153701,25832,121215,278,776,32,1943,3625,3219,75173,64122,11051,32255,31867,62298,7586,69884,0.5071,101500,35070
1600000US4839148,Killeen city,153095,45999,57055,1453,6110,2741,15324,24413,41425,61886,56587,5299,30034,26553,58577,6604,65181,0.4193,179900,51619
1600000US1232000,Hollywood city,153067,71051,26523,1109,4109,72,16305,33898,61031,72585,61941,10644,27278,34663,76596,4846,81442,0.4876,322400,60490
1600000US4751560,Murfreesboro city,152769,97785,29799,740,5797,103,6638,11907,13918,62905,58999,3906,30497,28502,90017,3958,93975,0.4151,323600,77584
1600000US4856000,Pasadena city,151950,66033,5468,1870,3468,73,37428,37610,103037,55994,51284,4710,24015,27269,63455,8389,71844,0.4475,192300,60939
1600000US5305210,Bellevue city,151854,67930,4018,542,61684,269,5096,12315,11071,64688,60953,3735,30058,30895,74682,4602,79284,0.4652,1107200,144274
1600000US0658072,Pomona city,151713,31901,8741,3499,16255,315,62598,28404,108044,43352,42050,1302,19762,22288,65798,7399,73197,0.4243,525300,70494
1600000US0622804,Escondido city,151038,63249,3602,2708,11974,394,43817,25294,78226,49998,48316,1682,23336,24980,71386,4490,75876,0.4432,620200,80749
1600000US1738570,Joliet city,150362,77065,24440,1501,3023,40,22785,21508,50510,52737,50341,2396,14378,35963,76329,6556,82885,0.4315,227500,76495
1600000US4513330,Charleston city,150227,110459,25553,380,3274,163,2449,7949,6818,77479,67675,9804,31511,36164,80671,3572,84243,0.4785,420800,74139
1600000US4847892,Mesquite city,150108,50295,37721,2049,4299,120,29823,25801,66272,52615,50123,2492,21603,28520,74369,5524,79893,0.4468,208900,60957
1600000US1751622,Naperville city,149540,94791,7469,258,33337,51,3330,10304,10374,55348,53208,2140,13459,39749,74047,4232,78279,0.4422,456400,129664
1600000US1765000,Rockford city,148655,77669,34240,1136,5213,44,14750,15603,29583,66612,60190,6422,28409,31781,58973,8676,67649,0.4664,101700,44525
1600000US0908000,Bridgeport city,148654,33697,52138,1398,4141,127,36513,20640,62853,58874,54261,4613,34181,20080,75537,6808,82345,0.5023,222800,46445
1600000US3673000,Syracuse city,148620,71175,45588,1408,10403,67,6574,13405,15625,66791,59336,7455,38920,20416,59583,4428,64011,0.4915,123000,40076
1600000US1369000,Savannah city,147780,56063,72618,459,5664,257,4532,8187,9789,68089,58949,9140,33360,25589,67078,5418,72496,0.4706,196900,49612
1600000US0662938,Roseville city,147773,96882,3756,1227,18714,546,7832,18816,24057,57318,55237,2081,18976,36261,75784,3330,79114,0.4035,605300,107714
1600000US0680000,Torrance city,147067,57337,5048,803,52509,603,11397,19370,28080,58775,56655,2120,25985,30670,69844,5201,75045,0.4439,930500,100392
1600000US0628000,Fullerton city,143617,52164,3284,1799,38382,349,26201,21438,54225,50411,48412,1999,24156,24256,68100,7270,75370,0.4852,790900,95431
1600000US0471510,Surprise city,143148,102613,7824,1283,3949,345,9076,18058,28373,58831,52309,6522,11853,40456,64333,2948,67281,0.3816,354100,78411
1600000US4845384,McAllen city,142210,48974,1178,1114,3688,33,25924,61299,123250,53622,48717,4905,19709,29008,64137,4711,68848,0.458,164300,57359
1600000US0877290,Thornton city,141867,85283,2967,2141,8451,162,18526,24337,51392,50733,48849,1884,13927,34922,75575,5330,80905,0.3627,449200,93873
1600000US0682954,Visalia city,141384,65272,2969,2761,8157,221,38042,23962,74575,48441,46561,1880,17943,28618,59639,5445,65084,0.4664,315100,64165
1600000US2052575,Olathe city,141290,104405,8444,735,6336,125,6739,14506,17485,51820,50070,1750,14208,35862,80048,1750,81798,0.4179,314300,99631
1600000US1225175,Gainesville city,141085,81107,29115,403,10998,57,5265,14140,19445,63612,57808,5804,38423,19385,68759,2830,71589,0.5032,195300,40822
1600000US4983470,West Valley City city,140230,69400,3915,2596,8031,6454,31493,18341,55278,42001,40774,1227,12888,27886,73419,3154,76573,0.356,343300,74348
1600000US0653980,Orange city,139911,65071,2442,1765,18392,388,28982,22871,57575,46893,45382,1511,19497,25885,69144,4692,73836,0.4355,827200,103045
1600000US4819972,Denton city,139869,85580,15910,1373,6121,177,12413,18295,34453,58085,54092,3993,29324,24768,82349,5609,87958,0.4588,288300,64873
1600000US2684000,Warren city,139387,86931,28386,411,14335,31,1387,7906,3563,58411,54933,3478,16622,38311,65428,8190,73618,0.4232,170000,60042
1600000US0656000,Pasadena city,138699,57835,11272,1883,24550,156,22024,20979,45742,61643,57984,3659,33122,24862,73172,5119,78291,0.5116,905900,86677
1600000US4876000,Waco city,138486,69083,27868,1449,3612,116,18611,17747,43857,58107,52226,5881,28999,23227,64326,3776,68102,0.5101,177300,49952
1600000US1912000,Cedar Rapids city,137710,107121,14338,402,3764,488,2274,9323,6502,62398,58128,4270,19933,38195,72678,3766,76444,0.4485,165500,60977
1600000US3921000,Dayton city,137644,65511,55981,514,1968,77,4567,9026,7859,68899,57751,11148,31629,26122,53370,5905,59275,0.4531,85000,39315
1600000US3421000,Elizabeth city,137298,27542,24260,1529,2908,53,51339,29667,90233,48439,46314,2125,35168,11146,62515,4457,66972,0.4621,405800,51549
1600000US5135000,Hampton city,137148,51202,67915,647,3568,241,3220,10355,8411,62444,57612,4832,26529,31083,64197,3940,68137,0.4538,211900,57647
1600000US4516000,Columbia city,136632,69276,52598,414,4183,122,3090,6949,8103,61010,53522,7488,30148,23374,63184,6929,70113,0.5453,218500,47524
1600000US5335415,Kent city,136588,54164,17423,1316,32240,3591,13258,14596,22449,49157,47058,2099,21474,25584,65978,5406,71384,0.4171,523000,81373
1600000US0973000,Stamford city,135470,69598,17032,965,11544,42,20438,15851,37958,56953,53241,3712,27955,25286,77459,3543,81002,0.497,576000,100543
1600000US0682590,Victorville city,134810,39804,24156,2780,5640,750,39728,21952,74745,38928,37024,1904,15744,21280,50735,7657,58392,0.398,323400,65478
1600000US1245975,Miramar city,134721,22226,57109,347,7940,41,13291,33767,55337,43826,42272,1554,13781,28491,76248,3635,79883,0.394,374600,79282
1600000US1214400,Coral Springs city,134394,57843,31227,382,7578,46,12063,25255,39472,47946,45892,2054,18718,27174,68752,4158,72910,0.4187,455000,81067
1600000US2676460,Sterling Heights city,134346,107043,8802,254,10960,17,1006,6264,3275,53255,51515,1740,13641,37874,61193,5592,66785,0.4345,237300,69104
1600000US0952000,New Haven city,134023,43775,43160,1290,9176,127,20465,16030,41068,57525,52263,5262,38913,13350,62934,5449,68383,0.4969,205500,50569
1600000US4813024,Carrollton city,133434,57718,13504,1412,22536,108,16445,21711,42272,53080,50301,2779,21080,29221,76433,3018,79451,0.42,302800,86647
1600000US4848072,Midland city,132524,76288,10446,1175,3501,163,16628,24323,55161,55424,48227,7197,16203,32024,68812,3768,72580,0.4664,276100,72038
1600000US4052500,Norman city,128026,89283,6398,5656,5083,107,5431,16068,11827,55694,50642,5052,24604,26038,65672,4694,70366,0.4774,228600,57786
1600000US0669084,Santa Clara city,127647,39504,2839,993,60002,450,11390,12469,22550,50229,47004,3225,28092,18912,70314,4682,74996,0.4518,1382300,155238
1600000US1303440,Athens-Clarke County unified government (balance),127315,73962,31420,574,4928,85,7814,8532,14244,55195,51074,4121,31241,19833,65321,2901,68222,0.462,237100,50299
1600000US0678582,Thousand Oaks city,126966,84912,1827,945,12667,178,9930,16507,25260,48131,46620,1511,13913,32707,59189,3902,63091,0.4687,858200,114791
1600000US2071000,Topeka city,126587,86642,13218,1723,2073,153,7707,15071,20749,60054,53938,6116,24354,29584,59323,2081,61404,0.4631,123400,49040
1600000US0672016,Simi Valley city,126356,75753,2039,1200,13526,210,15685,17943,35921,43927,43031,896,12119,30912,67695,4505,72200,0.4198,685500,101621
1600000US2915670,Columbia city,126254,91516,15038,398,7084,89,2734,9395,6195,55928,51124,4804,27949,23175,65995,3866,69861,0.4792,245800,60662
1600000US0681666,Vallejo city,126090,30451,25133,1426,29723,1343,22107,15907,35835,45523,43539,1984,19029,24510,56850,6238,63088,0.468,505400,77711
1600000US3825700,Fargo city,125990,99439,11033,2012,5173,93,1511,6729,4670,61541,56116,5425,32038,24078,70885,3098,73983,0.4857,238600,59089
1600000US4202000,Allentown city,125845,48176,16617,962,2614,63,37915,19498,68232,48533,45660,2873,26270,19390,52941,5920,58861,0.4399,173400,46745
1600000US4856348,Pearland city,125828,53512,24991,668,18848,84,9207,18518,31125,45403,43225,2178,10810,32415,60621,1959,62580,0.4041,307800,103227
1600000US0616000,Concord city,125410,59800,4789,1425,18802,693,21268,18633,38953,47597,45800,1797,18710,27090,61809,4449,66258,0.4419,719000,96961
1600000US4801000,Abilene city,125182,81300,13012,1114,2785,170,11590,15211,33634,51508,46134,5374,20842,25292,56366,1292,57658,0.4394,157900,51931
1600000US0803455,Arvada city,124402,100435,1342,1246,3210,82,4628,13459,18636,51261,49545,1716,13476,36069,67317,3175,70492,0.4096,537900,92647
1600000US0606000,Berkeley city,124321,66267,9812,653,24896,265,7848,14580,17018,52331,47606,4725,28603,19003,59365,6148,65513,0.5135,1270000,101048
1600000US2603000,Ann Arbor city,123851,83702,8393,265,19425,74,2196,9796,6793,53213,49948,3265,28119,21829,63892,2889,66781,0.5321,398600,68864
1600000US2935000,Independence city,123011,89323,10678,936,1468,826,6795,12985,15042,55654,51139,4515,20246,30893,54309,3423,57732,0.4472,154700,52919
1600000US2754880,Rochester city,121395,88892,10794,530,9543,70,3557,8009,7984,53210,49904,3306,17759,32145,65139,2851,67990,0.491,273800,75902
1600000US2240735,Lafayette city,121374,70577,37259,491,3158,38,2770,7081,7531,58634,52224,6410,23955,28269,61359,2772,64131,0.4835,214800,57953
1600000US0937000,Hartford city,121054,23462,46231,982,4283,83,30825,15188,53315,53259,47112,6147,36534,10578,50890,6912,57802,0.4801,174100,42468
1600000US4815976,College Station city,120511,76475,9788,593,12317,132,8903,12303,23357,48782,42433,6349,29011,13422,59614,3143,62757,0.5523,291300,49215
1600000US0614218,Clovis city,120124,66916,3312,1647,15643,339,14127,18140,36594,43954,42130,1824,15184,26946,55363,4225,59588,0.4264,418000,84837
1600000US0623182,Fairfield city,119881,38910,17866,1568,22447,1301,19549,18240,36723,40539,39026,1513,15549,23477,50252,4126,54378,0.4325,552300,90346
1600000US1254000,Palm Bay city,119760,72889,21386,464,2346,108,7072,15495,21436,49078,45799,3279,11454,34345,57017,2992,60009,0.5442,228400,54746
1600000US4861796,Richardson city,119469,64783,12829,663,20502,68,7510,13114,20528,49267,45812,3455,22146,23666,61212,4613,65825,0.4651,358000,85580
1600000US4863500,Round Rock city,119468,64290,12145,1014,9814,206,11512,20487,35744,45844,43536,2308,19622,23914,68916,3865,72781,0.4178,355600,79649
1600000US2511000,Cambridge city,118403,67887,12520,290,22743,54,4036,10873,10738,53907,49564,4343,34649,14915,70983,2751,73734,0.5164,1006100,104746
1600000US1652120,Meridian city,117635,98911,1156,629,3006,283,3271,10379,11228,43627,41230,2397,11016,30214,66308,1783,68091,0.4832,448100,88088
1600000US1276600,West Palm Beach city,117415,50857,37160,899,2963,51,10139,15346,28899,58706,50893,7813,27645,23248,57489,3401,60890,0.5001,311000,59400
1600000US1822000,Evansville city,117298,88374,16006,362,1455,596,2315,8190,5008,58361,51955,6406,24474,27481,55671,3250,58921,0.3893,111800,46662
1600000US1212875,Clearwater city,117292,79736,12301,823,3416,162,8272,12582,20441,62330,52142,10188,22824,29318,55842,2975,58817,0.4937,298000,56626
1600000US3006550,Billings city,117116,97840,1148,5788,1087,205,2256,8792,7937,52643,49441,3202,19241,30200,57026,2975,60001,0.4394,290000,65818
1600000US4982950,West Jordan city,116961,83147,1524,1194,3853,2502,11650,13091,26048,36247,35044,1203,8976,26068,58546,2917,61463,0.3615,410600,86252
1600000US0660620,Richmond city,116448,23452,22254,2395,16740,652,35720,15235,51912,40375,38677,1698,18865,19812,56564,5928,62492,0.4636,641500,85754
1600000US0883835,Westminster city,116317,81790,1987,1521,6480,105,8970,15464,27238,48905,46794,2111,17881,28913,66700,3227,69927,0.4154,457500,86688
1600000US3345140,Manchester city,115644,88744,6362,403,4831,43,6070,9191,13657,51438,49098,2340,27052,22046,68787,2710,71497,0.3702,321300,73639
1600000US2537000,Lowell city,115554,52594,10344,405,25776,64,14036,12335,25051,43482,41229,2253,24165,17064,57613,2878,60491,0.4197,380400,64221
1600000US3774440,Wilmington city,115451,81814,19091,504,1853,103,4517,7569,9544,59484,52731,6753,28153,24578,62051,4798,66849,0.5655,334900,53186
1600000US0602252,Antioch city,115291,32703,24057,1696,15015,1543,24028,16249,41965,36749,35548,1201,14101,21447,51393,4876,56269,0.4498,577900,81008
1600000US4807000,Beaumont city,115282,35844,54549,745,4387,54,11017,8686,20607,51953,45922,6031,21110,24812,53267,2615,55882,0.4673,150100,51361
1600000US4962470,Provo city,115162,85955,1072,1168,2844,1695,9433,12995,21395,36106,34067,2039,20418,13649,65644,2567,68211,0.4741,418800,57659
1600000US4550875,North Charleston city,114852,45672,46673,750,3388,147,10075,8147,16070,50563,45887,4676,24785,21102,61495,3857,65352,0.4978,229800,55864
1600000US1723074,Elgin city,114797,49850,7574,2751,7443,92,27932,19155,54460,40530,38727,1803,12630,26097,61275,3720,64995,0.3766,233200,79120
1600000US0611194,Carlsbad city,114746,83264,1340,676,9176,215,5535,14540,17302,47734,44775,2959,15733,29042,54199,3227,57426,0.448,1042900,124669
1600000US4853388,Odessa city,114428,56783,7512,1134,2523,277,21273,24926,64244,47309,41126,6183,14910,26216,58154,3826,61980,0.4498,196500,61964
1600000US0980000,Waterbury city,114403,46697,25038,857,2420,102,22902,16387,45281,48392,44425,3967,26160,18265,51019,6509,57528,0.4748,184300,48793
1600000US1772000,Springfield city,114394,78799,23344,298,3353,51,1222,7327,3582,57337,51223,6114,20073,31150,50010,4911,54921,0.4767,140100,62505
1600000US4841980,League City city,114392,75705,8533,586,7255,88,6448,15777,23884,43493,41352,2141,11235,30117,58267,2857,61124,0.3836,300000,101382
1600000US0619766,Downey city,114355,26731,4265,2357,7652,310,45758,27282,85866,36087,35017,1070,17501,17516,54465,3945,58410,0.4438,686000,72556
1600000US4131250,Gresham city,114247,71835,5957,1882,6886,1251,13106,13330,24043,42944,41333,1611,19645,21688,52292,4196,56488,0.416,411100,66129
1600000US3731400,High Point city,114059,51908,36610,695,10052,66,7279,7449,12784,47951,44382,3569,19871,24511,52232,3750,55982,0.4381,180300,57698
1600000US4009050,Broken Arrow city,113540,75198,5819,6311,5177,83,4416,16536,11638,44860,42699,2161,11934,30765,59174,3190,62364,0.4031,211600,73628
1600000US1759000,Peoria city,113150,61747,31527,415,7220,47,4247,7947,7899,54388,47493,6895,21670,25823,47451,4953,52404,0.5293,124500,47287
1600000US2646000,Lansing city,112644,61959,26328,916,4776,43,5580,13042,15467,54599,49503,5096,24285,25218,53828,5664,59492,0.4532,109900,48818
1600000US1238250,Lakeland city,112641,66712,21773,507,2493,79,8221,12856,22702,50869,45636,5233,20604,25032,50838,3045,53883,0.4589,186700,55029
1600000US1258050,Pompano Beach city,112046,50859,31994,687,1839,35,10177,16455,26611,59742,47751,11991,22105,25646,53542,5294,58836,0.4867,304000,53737
1600000US0616532,Costa Mesa city,111918,60574,1442,1455,9707,460,21391,16889,40795,44047,42179,1868,25761,16418,63813,3700,67513,0.4414,930500,97904
1600000US0862000,Pueblo city,111876,66342,3044,3073,1197,156,16428,21636,55133,48805,45648,3157,18953,26695,45434,3724,49158,0.5022,214500,49598
1600000US4842508,Lewisville city,111822,46844,17699,1339,12638,86,15747,17469,35853,46656,43926,2730,26112,17814,63960,4764,68724,0.3939,308800,75915
1600000US1245060,Miami Gardens city,111640,10409,70886,197,798,23,8542,20785,36711,35577,34284,1293,12724,21560,46546,4539,51085,0.4342,320600,54276
1600000US3539380,Las Cruces city,111385,57792,3026,2586,2101,118,18504,27258,67204,49414,45774,3640,20411,25363,48537,3894,52431,0.4851,182000,42058
1600000US4870808,Sugar Land city,111026,45186,8122,367,42831,40,3482,10998,13430,40118,38100,2018,7897,30203,49804,3557,53361,0.4765,369300,112868
1600000US0650076,Murrieta city,110949,59134,6711,1185,11566,521,12645,19187,33925,36809,35553,1256,11464,24089,47060,5044,52104,0.4007,573700,104708
1600000US0665042,San Buenaventura (Ventura) city,110763,68117,2018,1633,4444,215,15736,18600,38902,44612,42214,2398,18859,23355,54000,4497,58497,0.4379,702500,97816
1600000US5322640,Everett city,110629,68224,5931,1439,10602,1471,9813,13149,19083,47193,44879,2314,24582,20297,55487,2886,58373,0.4221,496900,70023
1600000US0678120,Temecula city,110003,61192,5171,1643,12458,472,11179,17888,30366,37170,35869,1301,12417,23452,46035,5552,51587,0.4156,613300,99805
1600000US2621000,Dearborn city,109976,95037,4435,178,2796,17,1381,6132,3940,39334,36935,2399,12507,24428,40211,3408,43619,0.4701,180900,61079
1600000US0669196,Santa Maria city,109707,31077,1288,4157,5435,166,44765,22819,83968,29960,28944,1016,14417,14527,47480,3730,51210,0.455,426100,69714
1600000US0684200,West Covina city,109501,21993,4045,1747,33632,210,27736,20138,58102,34834,33627,1207,13481,20146,49730,5242,54972,0.4534,636300,88476
1600000US0622230,El Monte city,109450,13958,903,2398,33198,63,42168,16762,70819,29893,29137,756,17516,11621,46885,4290,51175,0.4546,566600,55609
1600000US0832155,Greeley city,108795,67476,2895,1924,2146,126,16142,18086,43758,40566,38012,2554,15808,22204,50939,3446,54385,0.4539,347100,64853
1600000US3268400,Sparks city,108445,63816,3265,1752,7319,1037,15978,15278,32670,43332,41116,2216,17801,23315,55506,4621,60127,0.4002,423400,78778
1600000US0812815,Centennial city,108418,84109,3662,487,6894,130,2776,10360,10418,41571,40406,1165,8401,32005,54368,3027,57395,0.4237,578200,108531
1600000US0807850,Boulder city,108250,85303,1378,675,6968,130,5055,8741,11440,46289,43565,2724,23324,20241,56336,3288,59624,0.5459,941100,84167
1600000US1368516,Sandy Springs city,108080,60066,20230,404,10194,64,7291,9831,14740,53606,49833,3773,27540,22293,64007,2151,66158,0.5232,588300,94456
1600000US0636546,Inglewood city,107762,10271,41708,2197,2248,356,36491,14491,55677,39436,37853,1583,24155,13698,51562,6125,57687,0.4386,684500,68135
1600000US1372122,South Fulton city,107436,3734,97259,231,478,36,2015,3683,3528,41468,39021,2447,11381,27640,55095,4707,59802,0.4333,252500,73958
1600000US5531000,Green Bay city,107395,71574,5904,4721,4735,65,9030,11366,19220,45789,43673,2116,19647,24026,54981,2930,57911,0.4425,174400,51908
1600000US0608954,Burbank city,107337,65337,3078,808,12568,116,10806,14624,25961,45616,43644,1972,25344,18300,52897,5343,58240,0.5331,940400,81177
1600000US5357745,Renton city,106785,44704,10838,984,27917,847,9065,12430,16510,43362,41433,1929,19957,21476,54323,3697,58020,0.4336,587300,83699
1600000US4134100,Hillsboro city,106447,61512,3122,1428,13411,568,13300,13106,25618,42363,40328,2035,20195,20133,56760,3372,60132,0.3856,432600,97436
1600000US0621712,El Cajon city,106215,61728,7164,1156,5254,506,15415,14992,31271,36749,35610,1139,21598,14012,43843,6821,50664,0.4504,591600,61356
1600000US4874144,Tyler city,105995,55594,24496,689,3028,57,11913,10218,24023,46320,41836,4484,20360,21476,49879,3345,53224,0.476,195900,54998
1600000US1216475,Davie town,105691,53798,9249,434,6490,82,9955,25683,41769,41669,39025,2644,13819,25206,52217,2804,55021,0.4562,421300,73332
1600000US0668252,San Mateo city,105661,43826,1815,866,28047,1700,16065,13342,27198,42229,40263,1966,20216,20047,53888,3819,57707,0.4917,1518800,129957
1600000US2509000,Brockton city,105643,31074,36951,492,2278,29,13003,21816,12762,37304,35758,1546,16535,19223,51288,4437,55725,0.4773,367500,68581
1600000US3714100,Concord city,105240,57299,23537,537,7086,72,8089,8620,14637,40772,38599,2173,14307,24292,55918,3092,59010,0.4075,298600,79329
1600000US0637692,Jurupa Valley city,105053,30199,3790,2214,5523,300,43974,19053,74047,28734,27913,821,8943,18970,47924,4056,51980,0.4068,447500,81052
1600000US0617918,Daly City city,104901,15009,2531,980,60281,764,15925,9411,25237,33444,31777,1667,14623,17154,54751,5315,60066,0.4608,1052800,95424
1600000US4801924,Allen city,104627,56189,10245,547,22433,62,4026,11125,13197,36962,35491,1471,10710,24781,51899,1752,53651,0.3972,392000,107438
1600000US3563460,Rio Rancho city,104046,62638,3020,4382,2214,228,10929,20635,43334,39703,38178,1525,7521,30657,47272,4013,51285,0.3907,247200,76096
1600000US0660466,Rialto city,104026,21864,12358,2699,2698,385,44832,19190,77345,27954,27307,647,9879,17428,43961,4408,48369,0.3957,431500,69982
1600000US1871000,South Bend city,103453,55355,26628,677,1573,58,8704,10458,17249,47270,41451,5819,18633,22818,45373,2670,48043,0.497,114100,50248
1600000US5367167,Spokane Valley city,102976,85722,1812,1322,1970,710,2629,8811,7253,43751,41821,1930,17694,24127,53370,2736,56106,0.3881,323800,58904
1600000US0652526,Norwalk city,102773,20680,4178,2426,14038,451,39327,21673,73548,28455,27835,620,9859,17976,44676,4050,48726,0.3887,585200,79850
1600000US0646842,Menifee city,102527,53478,6941,1310,6629,502,16889,16778,38749,36526,34706,1820,7845,26861,45035,3997,49032,0.4363,442700,85175
1600000US0681554,Vacaville city,102386,52997,9796,1082,9196,789,12180,16346,27402,36012,34932,1080,12470,22462,48532,2710,51242,0.3742,566300,97777
1600000US4879000,Wichita Falls city,102316,63852,13315,1142,2547,154,9667,11639,23181,43625,38266,5359,16819,21447,44248,1826,46074,0.4697,118900,50786
1600000US1919000,Davenport city,101724,75332,12187,435,2240,38,2612,8880,8981,46964,42679,4285,17157,25522,50115,3131,53246,0.4953,146000,53914
1600000US2555745,Quincy city,101636,55975,5796,218,31282,20,2706,5639,5214,47009,44707,2302,25390,19317,57416,5259,62675,0.4594,563500,81748
1600000US0613014,Chico city,101475,71411,2035,1662,4493,359,9224,12291,20638,44429,41887,2542,23812,18075,49249,4464,53713,0.5027,420100,61850
1600000US2537490,Lynn city,101253,38669,12256,1426,6948,46,28160,13748,44560,36782,35335,1447,19178,16157,49812,2732,52544,0.4544,423800,64986
1600000US2941348,Lee's Summit city,101108,79516,9019,321,2401,147,1714,7990,5398,40373,38476,1897,9802,28674,52204,2307,54511,0.3895,303700,100246
1600000US2545000,New Bedford city,101079,61420,5867,1369,1043,54,15031,16295,24525,44588,41852,2736,25341,16511,45926,5277,51203,0.4298,305600,49237
1600000US5323515,Federal Way city,101030,41438,14572,1167,15617,4102,11655,12479,20266,37677,36140,1537,17114,19026,45348,3520,48868,0.4328,461000,78734
1600000US4822660,Edinburg city,100243,35674,1607,746,2652,18,19600,39946,88658,34729,32014,2715,14880,17134,43759,2180,45939,0.4487,153500,47596
1600000US1656260,Nampa city,100200,73408,882,1163,1101,455,11227,11964,25329,36221,34829,1392,11287,23542,53387,1403,54790,0.4186,350800,63471
1600000US5168000,Roanoke city,100011,57309,27470,419,2479,54,4795,7485,8484,48726,44411,4315,22643,21768,46819,2830,49649,0.4843,160000,47202